,Year,Month,Day,StockName,Positive,Negative,Neutral,Total Tweets
0,2020,1,1,NVDA,1,0,0,1
1,2020,1,2,NVDA,2,0,2,4
2,2020,1,3,NVDA,2,0,1,3
3,2020,1,4,NVDA,0,1,1,2
4,2020,1,5,NVDA,3,0,0,3
5,2020,1,6,NVDA,1,0,0,1
6,2020,1,7,NVDA,3,0,0,3
7,2020,1,8,NVDA,1,0,0,1
8,2020,1,9,NVDA,1,1,2,4
9,2020,1,10,NVDA,2,0,1,3
10,2020,1,11,NVDA,2,0,1,3
11,2020,1,12,NVDA,1,0,1,2
12,2020,1,13,NVDA,3,0,2,5
13,2020,1,14,NVDA,1,0,1,2
14,2020,1,15,NVDA,4,0,2,6
15,2020,1,16,NVDA,2,0,0,2
16,2020,1,17,NVDA,4,0,0,4
17,2020,1,18,NVDA,1,0,1,2
18,2020,1,19,NVDA,0,0,2,2
19,2020,1,20,NVDA,1,0,0,1
20,2020,1,21,NVDA,1,0,2,3
21,2020,1,22,NVDA,1,1,5,7
22,2020,1,23,NVDA,5,0,1,6
23,2020,1,24,NVDA,3,1,2,6
24,2020,1,25,NVDA,1,0,2,3
25,2020,1,26,NVDA,0,0,1,1
26,2020,1,27,NVDA,6,0,2,8
27,2020,1,28,NVDA,3,0,1,4
28,2020,1,29,NVDA,2,0,0,2
29,2020,1,30,NVDA,3,1,2,6
30,2020,1,31,NVDA,4,1,1,6
31,2020,2,1,NVDA,1,0,1,2
32,2020,2,2,NVDA,1,0,2,3
33,2020,2,3,NVDA,3,2,2,7
34,2020,2,4,NVDA,1,1,0,2
35,2020,2,5,NVDA,2,3,1,6
36,2020,2,6,NVDA,3,0,1,4
37,2020,2,7,NVDA,1,1,2,4
38,2020,2,8,NVDA,4,0,3,7
39,2020,2,9,NVDA,1,1,1,3
40,2020,2,10,NVDA,1,2,3,6
41,2020,2,11,NVDA,2,3,3,8
42,2020,2,12,NVDA,2,1,2,5
43,2020,2,13,NVDA,7,5,9,21
44,2020,2,14,NVDA,17,2,6,25
45,2020,2,15,NVDA,6,2,3,11
46,2020,2,16,NVDA,1,0,1,2
47,2020,2,17,NVDA,0,1,3,4
48,2020,2,18,NVDA,3,1,1,5
49,2020,2,19,NVDA,5,0,6,11
50,2020,2,20,NVDA,1,1,4,6
51,2020,2,21,NVDA,5,1,2,8
52,2020,2,22,NVDA,2,1,1,4
53,2020,2,23,NVDA,0,1,1,2
54,2020,2,24,NVDA,4,1,5,10
55,2020,2,25,NVDA,1,1,6,8
56,2020,2,26,NVDA,3,1,1,5
57,2020,2,27,NVDA,2,1,1,4
58,2020,2,28,NVDA,2,2,2,6
59,2020,2,29,NVDA,1,0,1,2
60,2020,3,1,NVDA,2,0,2,4
61,2020,3,2,NVDA,2,1,0,3
62,2020,3,3,NVDA,3,0,2,5
63,2020,3,4,NVDA,3,0,2,5
64,2020,3,5,NVDA,3,1,0,4
65,2020,3,6,NVDA,1,0,2,3
66,2020,3,7,NVDA,1,1,1,3
67,2020,3,8,NVDA,3,0,2,5
68,2020,3,9,NVDA,2,1,2,5
69,2020,3,10,NVDA,3,1,5,9
70,2020,3,11,NVDA,0,0,1,1
71,2020,3,12,NVDA,0,0,3,3
72,2020,3,13,NVDA,0,0,1,1
73,2020,3,14,NVDA,0,0,2,2
74,2020,3,15,NVDA,0,0,1,1
75,2020,3,16,NVDA,0,0,3,3
76,2020,3,17,NVDA,1,0,4,5
77,2020,3,18,NVDA,3,0,5,8
78,2020,3,19,NVDA,0,1,2,3
79,2020,3,20,NVDA,1,1,0,2
80,2020,3,21,NVDA,1,1,3,5
81,2020,3,23,NVDA,0,0,2,2
82,2020,3,24,NVDA,3,3,6,12
83,2020,3,25,NVDA,0,2,3,5
84,2020,3,26,NVDA,3,0,3,6
85,2020,3,27,NVDA,2,0,1,3
86,2020,3,28,NVDA,0,0,1,1
87,2020,3,29,NVDA,1,0,0,1
88,2020,3,30,NVDA,5,0,2,7
89,2020,3,31,NVDA,2,0,3,5
90,2020,4,1,NVDA,3,0,2,5
91,2020,4,2,NVDA,1,0,2,3
92,2020,4,3,NVDA,1,1,4,6
93,2020,4,4,NVDA,0,1,1,2
94,2020,4,5,NVDA,1,0,2,3
95,2020,4,6,NVDA,1,0,1,2
96,2020,4,7,NVDA,1,0,3,4
97,2020,4,8,NVDA,0,2,2,4
98,2020,4,9,NVDA,3,2,3,8
99,2020,4,10,NVDA,0,1,1,2
100,2020,4,11,NVDA,1,0,0,1
101,2020,4,12,NVDA,2,0,1,3
102,2020,4,13,NVDA,3,1,5,9
103,2020,4,14,NVDA,7,4,6,17
104,2020,4,15,NVDA,5,0,2,7
105,2020,4,16,NVDA,1,1,3,5
106,2020,4,17,NVDA,2,1,5,8
107,2020,4,18,NVDA,2,1,1,4
108,2020,4,19,NVDA,2,1,0,3
109,2020,4,20,NVDA,3,0,5,8
110,2020,4,21,NVDA,0,2,2,4
111,2020,4,22,NVDA,2,0,4,6
112,2020,4,23,NVDA,6,4,4,14
113,2020,4,24,NVDA,1,1,3,5
114,2020,4,25,NVDA,2,0,1,3
115,2020,4,26,NVDA,2,0,2,4
116,2020,4,27,NVDA,0,1,5,6
117,2020,4,28,NVDA,4,2,6,12
118,2020,4,29,NVDA,3,0,4,7
119,2020,4,30,NVDA,2,1,6,9
120,2020,5,1,NVDA,3,0,2,5
121,2020,5,2,NVDA,1,0,3,4
122,2020,5,3,NVDA,2,0,1,3
123,2020,5,4,NVDA,3,1,3,7
124,2020,5,5,NVDA,2,0,4,6
125,2020,5,6,NVDA,3,0,0,3
126,2020,5,7,NVDA,3,1,5,9
127,2020,5,8,NVDA,2,1,6,9
128,2020,5,9,NVDA,1,0,1,2
129,2020,5,10,NVDA,3,0,2,5
130,2020,5,11,NVDA,6,0,4,10
131,2020,5,12,NVDA,3,1,2,6
132,2020,5,13,NVDA,9,0,3,12
133,2020,5,14,NVDA,7,1,5,13
134,2020,5,15,NVDA,5,1,6,12
135,2020,5,16,NVDA,5,0,1,6
136,2020,5,17,NVDA,5,1,3,9
137,2020,5,18,NVDA,5,2,4,11
138,2020,5,19,NVDA,4,0,8,12
139,2020,5,20,NVDA,7,2,4,13
140,2020,5,21,NVDA,8,1,8,17
141,2020,5,22,NVDA,7,2,13,22
142,2020,5,23,NVDA,1,0,2,3
143,2020,5,24,NVDA,3,1,1,5
144,2020,5,25,NVDA,2,1,3,6
145,2020,5,26,NVDA,4,2,4,10
146,2020,5,27,NVDA,5,0,4,9
147,2020,5,28,NVDA,4,3,6,13
148,2020,5,29,NVDA,4,0,9,13
149,2020,5,30,NVDA,0,1,2,3
150,2020,5,31,NVDA,2,0,3,5
151,2020,6,1,NVDA,4,0,4,8
152,2020,6,2,NVDA,2,0,3,5
153,2020,6,3,NVDA,4,2,6,12
154,2020,6,4,NVDA,11,1,4,16
155,2020,6,5,NVDA,4,1,3,8
156,2020,6,6,NVDA,1,0,2,3
157,2020,6,7,NVDA,2,1,3,6
158,2020,6,8,NVDA,8,0,2,10
159,2020,6,9,NVDA,10,2,12,24
160,2020,6,10,NVDA,12,3,10,25
161,2020,6,11,NVDA,5,0,8,13
162,2020,6,12,NVDA,4,1,4,9
163,2020,6,13,NVDA,1,0,2,3
164,2020,6,14,NVDA,1,1,3,5
165,2020,6,15,NVDA,7,1,6,14
166,2020,6,16,NVDA,4,0,4,8
167,2020,6,17,NVDA,2,0,5,7
168,2020,6,18,NVDA,7,1,5,13
169,2020,6,19,NVDA,5,1,5,11
170,2020,6,20,NVDA,1,0,3,4
171,2020,6,22,NVDA,8,0,4,12
172,2020,6,23,NVDA,8,0,7,15
173,2020,6,24,NVDA,7,0,4,11
174,2020,6,25,NVDA,4,1,3,8
175,2020,6,26,NVDA,6,0,11,17
176,2020,6,27,NVDA,0,1,1,2
177,2020,6,28,NVDA,2,0,2,4
178,2020,6,29,NVDA,2,2,1,5
179,2020,6,30,NVDA,4,0,5,9
180,2020,7,1,NVDA,3,0,4,7
181,2020,7,2,NVDA,4,1,3,8
182,2020,7,3,NVDA,10,0,1,11
183,2020,7,4,NVDA,6,0,2,8
184,2020,7,5,NVDA,9,0,2,11
185,2020,7,6,NVDA,10,1,3,14
186,2020,7,7,NVDA,9,0,7,16
187,2020,7,8,NVDA,8,1,6,15
188,2020,7,9,NVDA,15,1,2,18
189,2020,7,10,NVDA,10,4,8,22
190,2020,7,11,NVDA,8,1,4,13
191,2020,7,12,NVDA,9,0,2,11
192,2020,7,13,NVDA,9,1,3,13
193,2020,7,14,NVDA,6,1,4,11
194,2020,7,15,NVDA,9,0,2,11
195,2020,7,16,NVDA,4,0,1,5
196,2020,7,17,NVDA,2,2,4,8
197,2020,7,18,NVDA,8,1,0,9
198,2020,7,19,NVDA,7,0,1,8
199,2020,7,20,NVDA,6,1,7,14
200,2020,7,21,NVDA,3,1,3,7
201,2020,7,22,NVDA,5,1,2,8
202,2020,7,23,NVDA,8,0,4,12
203,2020,7,24,NVDA,3,1,3,7
204,2020,7,25,NVDA,9,0,1,10
205,2020,7,26,NVDA,12,0,1,13
206,2020,7,27,NVDA,6,1,4,11
207,2020,7,28,NVDA,7,1,4,12
208,2020,7,29,NVDA,4,1,8,13
209,2020,7,30,NVDA,6,1,4,11
210,2020,7,31,NVDA,6,0,3,9
211,2020,8,1,NVDA,8,0,1,9
212,2020,8,2,NVDA,8,0,1,9
213,2020,8,3,NVDA,6,2,4,12
214,2020,8,4,NVDA,6,0,3,9
215,2020,8,5,NVDA,5,1,6,12
216,2020,8,6,NVDA,7,0,1,8
217,2020,8,7,NVDA,0,0,4,4
218,2020,8,8,NVDA,7,1,1,9
219,2020,8,9,NVDA,8,0,1,9
220,2020,8,10,NVDA,3,1,5,9
221,2020,8,11,NVDA,5,0,3,8
222,2020,8,12,NVDA,10,1,4,15
223,2020,8,13,NVDA,7,2,1,10
224,2020,8,14,NVDA,3,0,5,8
225,2020,8,15,NVDA,11,0,2,13
226,2020,8,16,NVDA,6,0,2,8
227,2020,8,17,NVDA,10,1,8,19
228,2020,8,18,NVDA,13,2,6,21
229,2020,8,19,NVDA,20,0,14,34
230,2020,8,20,NVDA,11,3,13,27
231,2020,8,21,NVDA,8,1,1,10
232,2020,8,22,NVDA,9,1,1,11
233,2020,8,23,NVDA,3,1,2,6
234,2020,8,24,NVDA,11,0,5,16
235,2020,8,25,NVDA,9,0,3,12
236,2020,8,26,NVDA,6,3,4,13
237,2020,8,27,NVDA,9,1,3,13
238,2020,8,28,NVDA,8,0,5,13
239,2020,8,29,NVDA,7,0,1,8
240,2020,8,30,NVDA,6,0,3,9
241,2020,8,31,NVDA,14,1,5,20
242,2020,9,1,NVDA,9,6,15,30
243,2020,9,2,NVDA,19,2,9,30
244,2020,9,3,NVDA,8,11,6,25
245,2020,9,4,NVDA,3,8,8,19
246,2020,9,5,NVDA,3,2,2,7
247,2020,9,6,NVDA,2,0,1,3
248,2020,9,7,NVDA,5,0,4,9
249,2020,9,8,NVDA,6,6,5,17
250,2020,9,9,NVDA,5,3,5,13
251,2020,9,10,NVDA,6,1,3,10
252,2020,9,11,NVDA,6,0,1,7
253,2020,9,12,NVDA,4,2,2,8
254,2020,9,13,NVDA,3,1,4,8
255,2020,9,14,NVDA,19,3,12,34
256,2020,9,15,NVDA,11,3,19,33
257,2020,9,16,NVDA,15,3,4,22
258,2020,9,17,NVDA,8,4,7,19
259,2020,9,18,NVDA,5,3,5,13
260,2020,9,19,NVDA,1,1,2,4
261,2020,9,20,NVDA,1,0,1,2
262,2020,9,21,NVDA,6,2,2,10
263,2020,9,22,NVDA,5,1,6,12
264,2020,9,23,NVDA,4,3,5,12
265,2020,9,24,NVDA,5,1,2,8
266,2020,9,25,NVDA,10,1,5,16
267,2020,9,26,NVDA,2,1,2,5
268,2020,9,27,NVDA,4,1,2,7
269,2020,9,28,NVDA,7,2,3,12
270,2020,9,29,NVDA,10,1,8,19
271,2020,9,30,NVDA,13,3,7,23
272,2020,10,1,NVDA,4,1,7,12
273,2020,10,2,NVDA,3,1,3,7
274,2020,10,3,NVDA,2,0,1,3
275,2020,10,4,NVDA,3,0,0,3
276,2020,10,5,NVDA,10,0,4,14
277,2020,10,6,NVDA,7,0,9,16
278,2020,10,7,NVDA,6,0,5,11
279,2020,10,8,NVDA,6,2,2,10
280,2020,10,9,NVDA,8,0,4,12
281,2020,10,10,NVDA,2,1,0,3
282,2020,10,11,NVDA,4,0,2,6
283,2020,10,12,NVDA,6,0,4,10
284,2020,10,13,NVDA,2,0,7,9
285,2020,10,14,NVDA,4,1,2,7
286,2020,10,15,NVDA,7,0,3,10
287,2020,10,16,NVDA,4,1,1,6
288,2020,10,17,NVDA,3,2,0,5
289,2020,10,18,NVDA,2,2,3,7
290,2020,10,19,NVDA,2,0,0,2
291,2020,10,20,NVDA,3,0,8,11
292,2020,10,21,NVDA,4,3,5,12
293,2020,10,22,NVDA,4,0,4,8
294,2020,10,23,NVDA,2,1,5,8
295,2020,10,24,NVDA,0,0,2,2
296,2020,10,25,NVDA,1,0,0,1
297,2020,10,26,NVDA,3,1,3,7
298,2020,10,27,NVDA,3,0,3,6
299,2020,10,28,NVDA,4,0,5,9
300,2020,10,29,NVDA,6,0,4,10
301,2020,10,30,NVDA,3,2,7,12
302,2020,10,31,NVDA,2,2,2,6
303,2020,11,1,NVDA,5,0,2,7
304,2020,11,2,NVDA,1,0,4,5
305,2020,11,3,NVDA,4,0,4,8
306,2020,11,4,NVDA,3,0,4,7
307,2020,11,5,NVDA,1,1,2,4
308,2020,11,6,NVDA,5,1,2,8
309,2020,11,7,NVDA,1,0,3,4
310,2020,11,8,NVDA,2,0,5,7
311,2020,11,9,NVDA,8,6,3,17
312,2020,11,10,NVDA,5,4,3,12
313,2020,11,11,NVDA,7,1,8,16
314,2020,11,12,NVDA,5,4,2,11
315,2020,11,13,NVDA,5,4,2,11
316,2020,11,14,NVDA,2,0,0,2
317,2020,11,15,NVDA,2,0,3,5
318,2020,11,16,NVDA,3,0,4,7
319,2020,11,17,NVDA,7,1,5,13
320,2020,11,18,NVDA,7,1,14,22
321,2020,11,19,NVDA,4,2,8,14
322,2020,11,20,NVDA,2,0,3,5
323,2020,11,21,NVDA,0,4,1,5
324,2020,11,22,NVDA,4,1,2,7
325,2020,11,23,NVDA,6,0,5,11
326,2020,11,24,NVDA,2,2,5,9
327,2020,11,25,NVDA,8,3,3,14
328,2020,11,26,NVDA,0,1,3,4
329,2020,11,27,NVDA,2,0,2,4
330,2020,11,28,NVDA,6,0,2,8
331,2020,11,29,NVDA,4,1,2,7
332,2020,11,30,NVDA,6,1,3,10
333,2020,12,1,NVDA,7,1,6,14
334,2020,12,2,NVDA,4,0,7,11
335,2020,12,3,NVDA,4,0,4,8
336,2020,12,4,NVDA,1,6,2,9
337,2020,12,5,NVDA,1,1,0,2
338,2020,12,6,NVDA,0,0,1,1
339,2020,12,7,NVDA,6,0,2,8
340,2020,12,8,NVDA,9,1,4,14
341,2020,12,9,NVDA,5,0,1,6
342,2020,12,10,NVDA,5,4,3,12
343,2020,12,11,NVDA,1,0,7,8
344,2020,12,12,NVDA,1,0,1,2
345,2020,12,13,NVDA,1,1,3,5
346,2020,12,14,NVDA,1,1,9,11
347,2020,12,15,NVDA,5,1,4,10
348,2020,12,16,NVDA,1,1,3,5
349,2020,12,17,NVDA,3,4,7,14
350,2020,12,18,NVDA,5,0,3,8
351,2020,12,20,NVDA,3,1,1,5
352,2020,12,21,NVDA,2,1,4,7
353,2020,12,22,NVDA,6,1,6,13
354,2020,12,23,NVDA,3,0,2,5
355,2020,12,24,NVDA,1,1,3,5
356,2020,12,25,NVDA,0,0,2,2
357,2020,12,26,NVDA,1,0,2,3
358,2020,12,27,NVDA,1,2,0,3
359,2020,12,28,NVDA,2,2,3,7
360,2020,12,29,NVDA,1,1,4,6
361,2020,12,30,NVDA,1,3,3,7
362,2020,12,31,NVDA,5,0,5,10
363,2021,1,1,NVDA,2,1,0,3
364,2021,1,2,NVDA,1,1,1,3
365,2021,1,3,NVDA,4,0,1,5
366,2021,1,4,NVDA,7,2,4,13
367,2021,1,5,NVDA,6,1,4,11
368,2021,1,6,NVDA,1,0,6,7
369,2021,1,7,NVDA,6,1,6,13
370,2021,1,8,NVDA,2,2,0,4
371,2021,1,9,NVDA,5,1,6,12
372,2021,1,10,NVDA,8,2,2,12
373,2021,1,11,NVDA,5,1,4,10
374,2021,1,12,NVDA,5,3,13,21
375,2021,1,13,NVDA,5,1,5,11
376,2021,1,14,NVDA,2,1,1,4
377,2021,1,15,NVDA,2,0,2,4
378,2021,1,16,NVDA,3,0,3,6
379,2021,1,17,NVDA,0,0,2,2
380,2021,1,18,NVDA,2,0,2,4
381,2021,1,19,NVDA,4,1,5,10
382,2021,1,20,NVDA,8,0,7,15
383,2021,1,21,NVDA,9,1,9,19
384,2021,1,22,NVDA,8,1,2,11
385,2021,1,23,NVDA,1,0,2,3
386,2021,1,24,NVDA,1,0,4,5
387,2021,1,25,NVDA,8,1,6,15
388,2021,1,26,NVDA,3,3,4,10
389,2021,1,27,NVDA,2,2,7,11
390,2021,1,28,NVDA,4,2,2,8
391,2021,1,29,NVDA,1,2,2,5
392,2021,1,30,NVDA,1,1,2,4
393,2021,1,31,NVDA,5,2,0,7
394,2021,2,1,NVDA,4,2,1,7
395,2021,2,2,NVDA,4,3,3,10
396,2021,2,3,NVDA,7,2,4,13
397,2021,2,4,NVDA,9,1,5,15
398,2021,2,5,NVDA,4,0,6,10
399,2021,2,6,NVDA,4,1,1,6
400,2021,2,7,NVDA,2,2,1,5
401,2021,2,8,NVDA,13,1,15,29
402,2021,2,9,NVDA,11,7,9,27
403,2021,2,10,NVDA,10,2,11,23
404,2021,2,11,NVDA,20,5,5,30
405,2021,2,12,NVDA,13,3,9,25
406,2021,2,13,NVDA,8,1,1,10
407,2021,2,14,NVDA,4,0,2,6
408,2021,2,15,NVDA,7,0,0,7
409,2021,2,16,NVDA,6,1,7,14
410,2021,2,17,NVDA,7,2,6,15
411,2021,2,18,NVDA,5,3,4,12
412,2021,2,19,NVDA,8,1,7,16
413,2021,2,20,NVDA,4,1,4,9
414,2021,2,21,NVDA,4,3,2,9
415,2021,2,22,NVDA,3,7,8,18
416,2021,2,23,NVDA,5,4,4,13
417,2021,2,24,NVDA,9,4,12,25
418,2021,2,25,NVDA,7,4,16,27
419,2021,2,26,NVDA,9,3,0,12
420,2021,2,27,NVDA,1,0,2,3
421,2021,2,28,NVDA,2,0,1,3
422,2021,3,1,NVDA,6,1,3,10
423,2021,3,2,NVDA,4,3,4,11
424,2021,3,3,NVDA,2,2,9,13
425,2021,3,4,NVDA,7,3,5,15
426,2021,3,5,NVDA,6,1,8,15
427,2021,3,6,NVDA,4,4,1,9
428,2021,3,7,NVDA,1,0,1,2
429,2021,3,8,NVDA,4,3,9,16
430,2021,3,9,NVDA,11,5,7,23
431,2021,3,10,NVDA,4,1,7,12
432,2021,3,11,NVDA,6,5,3,14
433,2021,3,12,NVDA,4,2,5,11
434,2021,3,13,NVDA,4,0,9,13
435,2021,3,14,NVDA,2,0,1,3
436,2021,3,15,NVDA,4,1,4,9
437,2021,3,16,NVDA,10,1,3,14
438,2021,3,17,NVDA,4,1,6,11
439,2021,3,18,NVDA,4,1,7,12
440,2021,3,19,NVDA,5,3,8,16
441,2021,3,20,NVDA,0,1,2,3
442,2021,3,21,NVDA,2,3,2,7
443,2021,3,22,NVDA,3,2,10,15
444,2021,3,23,NVDA,6,2,4,12
445,2021,3,24,NVDA,3,2,3,8
446,2021,3,25,NVDA,2,1,5,8
447,2021,3,26,NVDA,8,3,3,14
448,2021,3,27,NVDA,6,3,4,13
449,2021,3,28,NVDA,3,3,2,8
450,2021,3,29,NVDA,0,1,7,8
451,2021,3,30,NVDA,6,3,3,12
452,2021,3,31,NVDA,5,2,4,11
453,2021,4,1,NVDA,4,1,4,9
454,2021,4,2,NVDA,2,1,2,5
455,2021,4,3,NVDA,3,2,2,7
456,2021,4,4,NVDA,0,3,1,4
457,2021,4,5,NVDA,3,2,7,12
458,2021,4,6,NVDA,8,2,5,15
459,2021,4,7,NVDA,3,4,4,11
460,2021,4,8,NVDA,3,1,6,10
461,2021,4,9,NVDA,6,5,4,15
462,2021,4,10,NVDA,2,0,2,4
463,2021,4,11,NVDA,1,0,3,4
464,2021,4,12,NVDA,10,6,16,32
465,2021,4,13,NVDA,15,7,29,51
466,2021,4,14,NVDA,4,1,4,9
467,2021,4,15,NVDA,9,3,8,20
468,2021,4,16,NVDA,4,3,5,12
469,2021,4,17,NVDA,3,1,3,7
470,2021,4,18,NVDA,4,0,2,6
471,2021,4,19,NVDA,12,3,6,21
472,2021,4,20,NVDA,5,6,7,18
473,2021,4,21,NVDA,10,3,5,18
474,2021,4,22,NVDA,5,0,2,7
475,2021,4,23,NVDA,3,1,6,10
476,2021,4,24,NVDA,2,0,2,4
477,2021,4,25,NVDA,3,2,0,5
478,2021,4,26,NVDA,4,0,4,8
479,2021,4,27,NVDA,0,3,5,8
480,2021,4,28,NVDA,2,1,2,5
481,2021,4,29,NVDA,2,2,8,12
482,2021,4,30,NVDA,2,1,2,5
483,2021,5,1,NVDA,6,1,0,7
484,2021,5,2,NVDA,7,0,1,8
485,2021,5,3,NVDA,3,0,5,8
486,2021,5,4,NVDA,5,2,2,9
487,2021,5,5,NVDA,8,2,3,13
488,2021,5,6,NVDA,5,0,0,5
489,2021,5,7,NVDA,4,0,2,6
490,2021,5,8,NVDA,1,0,0,1
491,2021,5,9,NVDA,2,0,1,3
492,2021,5,10,NVDA,0,2,2,4
493,2021,5,11,NVDA,4,1,2,7
494,2021,5,12,NVDA,2,1,2,5
495,2021,5,13,NVDA,2,0,2,4
496,2021,5,14,NVDA,5,1,11,17
497,2021,5,15,NVDA,3,0,0,3
498,2021,5,16,NVDA,3,0,0,3
499,2021,5,17,NVDA,3,2,3,8
500,2021,5,18,NVDA,6,0,2,8
501,2021,5,19,NVDA,2,1,4,7
502,2021,5,20,NVDA,12,1,2,15
503,2021,5,21,NVDA,14,4,17,35
504,2021,5,22,NVDA,4,2,6,12
505,2021,5,23,NVDA,3,1,1,5
506,2021,5,24,NVDA,11,4,12,27
507,2021,5,25,NVDA,10,5,4,19
508,2021,5,26,NVDA,12,1,17,30
509,2021,5,27,NVDA,6,2,13,21
510,2021,5,28,NVDA,10,6,7,23
511,2021,5,29,NVDA,3,2,7,12
512,2021,5,30,NVDA,3,1,4,8
513,2021,5,31,NVDA,2,2,1,5
514,2021,6,1,NVDA,11,1,3,15
515,2021,6,2,NVDA,9,2,7,18
516,2021,6,3,NVDA,7,3,10,20
517,2021,6,4,NVDA,18,3,7,28
518,2021,6,5,NVDA,4,2,6,12
519,2021,6,6,NVDA,4,1,8,13
520,2021,6,7,NVDA,6,0,5,11
521,2021,6,8,NVDA,5,2,4,11
522,2021,6,9,NVDA,7,0,6,13
523,2021,6,10,NVDA,3,2,6,11
524,2021,6,11,NVDA,6,0,6,12
525,2021,6,12,NVDA,5,1,2,8
526,2021,6,13,NVDA,0,1,3,4
527,2021,6,14,NVDA,7,1,7,15
528,2021,6,15,NVDA,2,1,2,5
529,2021,6,16,NVDA,4,1,1,6
530,2021,6,17,NVDA,9,1,7,17
531,2021,6,18,NVDA,12,3,15,30
532,2021,6,19,NVDA,6,2,3,11
533,2021,6,20,NVDA,6,3,5,14
534,2021,6,21,NVDA,11,1,11,23
535,2021,6,22,NVDA,10,4,4,18
536,2021,6,23,NVDA,4,0,1,5
537,2021,6,24,NVDA,3,2,3,8
538,2021,6,25,NVDA,3,2,1,6
539,2021,6,26,NVDA,2,0,4,6
540,2021,6,27,NVDA,2,0,1,3
541,2021,6,28,NVDA,16,2,5,23
542,2021,6,29,NVDA,11,4,2,17
543,2021,6,30,NVDA,8,1,5,14
544,2021,7,1,NVDA,14,2,5,21
545,2021,7,2,NVDA,6,1,6,13
546,2021,7,3,NVDA,3,4,3,10
547,2021,7,4,NVDA,1,0,0,1
548,2021,7,5,NVDA,1,0,3,4
549,2021,7,6,NVDA,14,3,4,21
550,2021,7,7,NVDA,4,3,6,13
551,2021,7,8,NVDA,10,1,1,12
552,2021,7,9,NVDA,6,2,8,16
553,2021,7,10,NVDA,3,2,6,11
554,2021,7,11,NVDA,1,2,1,4
555,2021,7,12,NVDA,6,2,4,12
556,2021,7,13,NVDA,9,3,6,18
557,2021,7,14,NVDA,3,2,1,6
558,2021,7,15,NVDA,7,6,13,26
559,2021,7,16,NVDA,8,1,14,23
560,2021,7,17,NVDA,6,0,7,13
561,2021,7,18,NVDA,3,2,1,6
562,2021,7,19,NVDA,23,3,11,37
563,2021,7,20,NVDA,20,5,8,33
564,2021,7,21,NVDA,17,6,12,35
565,2021,7,22,NVDA,6,2,8,16
566,2021,7,23,NVDA,6,3,5,14
567,2021,7,24,NVDA,2,1,1,4
568,2021,7,25,NVDA,6,1,4,11
569,2021,7,26,NVDA,6,2,2,10
570,2021,7,27,NVDA,3,0,3,6
571,2021,7,28,NVDA,5,2,4,11
572,2021,7,29,NVDA,3,2,2,7
573,2021,7,30,NVDA,3,0,3,6
574,2021,7,31,NVDA,4,1,1,6
575,2021,8,1,NVDA,1,0,0,1
576,2021,8,2,NVDA,6,0,4,10
577,2021,8,3,NVDA,5,2,9,16
578,2021,8,4,NVDA,3,2,4,9
579,2021,8,5,NVDA,11,1,7,19
580,2021,8,6,NVDA,3,3,3,9
581,2021,8,7,NVDA,2,1,0,3
582,2021,8,8,NVDA,2,1,1,4
583,2021,8,9,NVDA,5,2,0,7
584,2021,8,10,NVDA,3,3,5,11
585,2021,8,11,NVDA,3,1,2,6
586,2021,8,12,NVDA,8,1,1,10
587,2021,8,13,NVDA,3,1,4,8
588,2021,8,14,NVDA,5,2,3,10
589,2021,8,15,NVDA,4,2,4,10
590,2021,8,16,NVDA,3,0,1,4
591,2021,8,17,NVDA,5,2,1,8
592,2021,8,18,NVDA,8,3,11,22
593,2021,8,19,NVDA,23,7,23,53
594,2021,8,20,NVDA,17,5,11,33
595,2021,8,21,NVDA,11,2,4,17
596,2021,8,22,NVDA,3,0,6,9
597,2021,8,23,NVDA,24,7,13,44
598,2021,8,24,NVDA,7,1,6,14
599,2021,8,25,NVDA,14,1,11,26
600,2021,8,26,NVDA,4,4,8,16
601,2021,8,27,NVDA,7,3,5,15
602,2021,8,28,NVDA,4,0,2,6
603,2021,8,29,NVDA,7,2,3,12
604,2021,8,30,NVDA,7,2,5,14
605,2021,8,31,NVDA,7,4,10,21
606,2021,9,1,NVDA,5,3,4,12
607,2021,9,2,NVDA,13,3,1,17
608,2021,9,3,NVDA,7,2,4,13
609,2021,9,4,NVDA,1,1,0,2
610,2021,9,5,NVDA,1,0,5,6
611,2021,9,6,NVDA,3,1,1,5
612,2021,9,7,NVDA,3,0,5,8
613,2021,9,8,NVDA,3,2,4,9
614,2021,9,9,NVDA,1,3,4,8
615,2021,9,10,NVDA,6,2,2,10
616,2021,9,11,NVDA,0,0,1,1
617,2021,9,12,NVDA,3,0,0,3
618,2021,9,13,NVDA,7,5,5,17
619,2021,9,14,NVDA,2,0,8,10
620,2021,9,15,NVDA,2,1,4,7
621,2021,9,16,NVDA,9,2,4,15
622,2021,9,17,NVDA,0,1,2,3
623,2021,9,18,NVDA,4,0,0,4
624,2021,9,19,NVDA,0,0,3,3
625,2021,9,20,NVDA,3,4,3,10
626,2021,9,21,NVDA,4,4,1,9
